24 15 80
VVVVVVVVVVVVVVVVVVVVVVVV
VVVVVVVVVVVVVVVVVVVVVVVV
VVVVVVVVVVVVVVVVVVVVVVVV
VVVVVVVVVVVVVVVVVVVVVVVV
VVVVVVVVVVVVVVVVVVVVVVVV
VVVVVVVVVVVVVVVVVVVVVVVV
VVVVVVVVVVVVVVVVVVVVVVVV
VVVVVVVVVVVVVVVVVVVVVVVV
VVVVVVVVVVVVVVVVVVVVVVVV
VVVVVVVVVVVVVVVVVVVVVVVZ
VVVVVVVVVVVVVVV1VVVVKVVD
VVJLVVVVVVJLVVVKVVVKVV1D
VVVVVVVVVVVVV1VVVV1VV2AB
VPVV2VABCVVVVBV2VACVVABB
WBCWWWDEFWWWWEWWWDFWWDEE
Back.png
