24 15 80
VV1VV121VVVVV121VV1VVVVV
VVVVVVVVVVVVVV1VVVVVVV1V
V1VJKLVVVVJKLVVVVVVABCVV
VVVVVVVVVVVVVVVVVVVGHIVV
JKKLVV1VVVV1VVA11CVV1VV1
VV1VVVVVVABCVVGHHIVV2VVA
VVVVVJLVVDEFVVVVVVVV1VVG
VVVVVVVVVGHIVVVVVVVVVVVV
1VJLVV1VVVV121VVVJLVVVVZ
VVVVVACVVVVVVVVVVVVV1VVA
LVVVVGIVVVVVVVV1VVVVKVVD
VVJLVVVVVVJLVVVKVVVKVV1D
VVVVVVVVVVVVV1VVVV1VV2AB
CPVVVVABCVVVVBVVVACVVABB
BBCWWWDEFWWWWEWWWDFWWDEE
Back.png